はじめの切替
#########
#S.LBl..#
####..###
#...#Dd.#
#...#...#
#.......#
#########
