縦押しの木箱
scale=2
#########
#.l...D.#
#...#...#
#F..#...#
#...#...#
#.L...d.#
#########
