はじめの切替
##########
#.....F..#
#.L......#
#...B.B..#
#........#
#........#
#.d....D.#
#....l...#
##########
