ふたつの木箱
scale=3
L....F..
...B....
.....B..
........
......D.
..d.l...
