はじめの切替
scale=1
.....F..
.L......
...B.B..
........
........
.d....D.
....l...
