縦押しの木箱
#########
###.....#
###l#.###
###B#.###
#..L#D.d#
#..S#...#
#########
