橋渡し
scale=2
.S.......
L.......l
X.B.X.B..
.........
.........
D.......d
.........
