橋渡し
scale=2
..S...XX
L......d
XX...B..
...B....
l.......
D.......
........
