光源を押す
#########
#.lSL...#
#####...#
#...#D.d#
#...#...#
#.......#
#########
