急がば回れ
scale=2
..#d..L
..S....
...B#..
.Bl....
B......
D......

//...........
//d..........
//XXX.....X..
//.....L..X..
//..SB...lX..
//.B......X..
//D..........
