二つの宝
scale=1
###############
##########....#
#.............#
#.l.L.#.......#
#....B........#
#.....#.d.....#
#..S..#.......#
#.....#.D.....#
###############
