二つの宝
###########
###########
#.lSL.#...#
#....B....#
#.F...#.d.#
#..S..#...#
####..#.D.#
###########
